l,1,1,1,1,1,1,1,1,1
l,1,1,1,1,1,1,1,1,1
l,1,1,1,1,1,1,1,vNwSwEwWd,1
l,1,1,1,1,r,1,1,1,1
l,b,1,1,1,_,l,1,1,1
l,1,r,1,1,1,1,1,1,1
l,1,0,l,1,1,1,1,1,1
l,1,1,1,1,1,1,1,1,1
l,1,1,1,1,1,1,v,1,1
c,r,r,r,r,r,r,r,r,r
,,,,,,,,,
l,1,1,1,1,1,1,1,1,1
l,1,1,1,1,1,1,1,1,1
l,1,1,1,1,1,1,1,1,1
l,1,1,>,1,1,1,1,1,1
l,1,1,1,B,^,1,1,1,1
l,1,1,1,1,1,1,1,1,1
l,1,1,1,1,1,1,1,1,1
l,1,1,1,1,1,1,1,1,1
l,1,1,v,1,1,1,1,1,1
c,r,r,r,r,r,r,r,r,r
,,,,,,,,,
