1,1,1,1,1,1,1,1,1,l
1,1,1,1,1,1,1,1,1,l
1,1,1,1,1,>,1,1,1,l
1,1,1,1,1,r,1,1,1,l
1,1,1,1,l,0,1,1,1,l
1,1,1,1,1,1,1,1,1,l
1,1,1,_,1,1,1,1,1,l
1,1,1,1,1,1,1,1,1,l
1,1,1,1,1,1,1,1,1,l
r,r,r,r,r,r,r,r,r,c
,,,,,,,,,
B,B,B,1,1,1,1,1,1,l
B,>,B,1,1,1,1,1,1,l
B,1,B,1,1,1,1,1,1,l
B,>,B,1,1,1,1,1,1,l
1,1,1,1,1,1,1,1,1,l
1,1,1,1,1,1,1,1,1,l
1,1,1,^,1,1,1,1,1,l
1,1,1,1,1,1,1,1,1,l
1,1,0,0,0,0,1,1,1,l
r,r,0,br,bc,0,r,r,r,c
