l,r,r,r,r,r,r,r,r,1
l,0,0,0,0,0,0,0,0,l
l,b,b,b,b,b,b,b,b,1
l,B,B,B,B,B,B,B,B,1
l,>,>,>,>,>,>,>,>,1
l,v,v,v,v,v,v,v,v,1
l,_,_,_,_,_,_,_,_,1
l,/,/,/,/,/,/,/,/,1
l,or,o,o,o,o,o,o,o,1
c,u,u,u,u,u,u,u,u,c
,,,,,,,,,
l,r,1,1,r,1,1,r,1,1
l,0,l,1,1,l,1,0,l,1
l,1,1,1,1,1,1,1,1,1
l,rNdEdSwWw,1,1,r,1,1,r,1,1
l,0,l,1,1,l,1,0,l,1
l,-,-,-,1,-,-,-,-,1
l,^r,^,^,1,^,^,^r,^,1
l,1,1,1,1,1,1,1,1,1
l,1,1,1,1,1,1,1,1,1
c,r,r,r,r,r,r,r,r,r
