0,0,l,1,1,1,1,1,1,1
0,l,1,1,1,1,1,1,1,1
l,1,1,v,1,1,1,1,>,1
l,1,1,1,1,1,1,1,1,1
l,1,1,1,1,1,1,1,1,1
l,r,r,1,1,1,1,1,1,1
c,0,0,l,1,1,1,r,1,1
0,0,0,l,1,1,1,0,l,1
0,l,1,1,1,1,1,1,1,1
c,r,r,r,r,r,r,r,r,r
,,,,,,,,,
l,1,1,1,1,1,1,1,1,1
l,1,1,1,1,1,1,1,1,r
l,1,1NwEwSwWd,1,1,1,1,1,r,0
l,1,1,1,1,1,1,1,0,0
l,1,1,1,1,1,1,1,0,0
c,1,1,1,1,1,1,1,1,1
0,c,1,1,1,1,1,1,1,1
0,0,l,1,1,1,1,1,1,1
0,0,l,1,1,1,1,1,1,1
0,c,r,r,r,r,r,r,r,r
