1,1,1,1,1,1,1,1,1,l
1,1,>,1,1,1,1,r,1,l
1,1,1,1,1,1,l,0,1,l
1,1,1,1,1,1,1,1,1,l
1,1,1,1,1,1,1,1,1,l
1,1,1,1,1,1,1,1,1,l
1,1,v,1,1,1,1,1,1,l
c,1,1,1,1,1,r,r,1,l
0,r,1,1,1,l,0,0,c,l
0,0,c,r,r,r,c,0,0,c
,,,,,,,,,
1,1,0,0,0,1,1,1,1,l
1,1,1,0,0,1,1,1,1,l
1,1,1,1,1,1,1,1,1,l
1,1,1,1,1,1,1,1,1,l
1,1,1,1,1,1,1,1,1,l
1,1,1,1,1,1,1,1,1,l
1,1,1NwEwSwWd,1,1,1,1,1,1,l
1,1,1,1,1,1,r,r,r,l
1,1,1,1,1,l,0,0,0,l
c,r,r,r,r,c,0,0,0,c
