1,1,1,1,1,1,1,1,1,l
1,1,1,1,1,1,1,1,1,l
1,1,1,1,1,1,1,1,1,l
1,1,1,/,1,/,1,1,1,l
1,1,1,1,1,1,1,1,1,l
1,1,1,/,1,/,1,1,1,l
1,1,1,1,1,1,1,1,1,l
1,1,1,1,1,1,1,1,1,l
1,1,1,1,1,1,1,1,1,l
r,r,r,r,r,r,r,r,r,c
,,,,,,,,,
1,1,1,1,1,1,l,0,0,0
1,1,1,1,1,1,1,1,c,0
1,1,1,1,1,1,1,l,0,0
1,1,1,1,/,1,1,1,l,0
1,1,1,/,1,/,1,1,1,l
1,1,1,1,/,1,1,1,1,l
1,1,1,1,1,1,1,1,1,l
1,1,1,1,1,1,1,1,1,l
1,1,1,1,1,1,1,1,1,l
r,r,r,r,r,r,r,r,r,c
