1,1,1,1,1,1,1,1,1,l
1,1,vNwSwEwWd,1,1,1,1,1,1,l
1,1,1,1,1,1,1,1,v,l
1,1,1,1,1,1,1,1,1,l
1,1,1,1,_,1,1,1,1,l
1,1,1,1,1,1,1,1,1,l
1,1,1,1,1,1,r,1,1,l
1,1,1,1,1,l,0,1,1,l
1,1,1,1,b,1,1,1,1,l
r,r,r,r,r,r,r,r,r,c
,,,,,,,,,
1,1,1,1,1,1,1,1,1,l
1,1,1,1,1,1,1,1,1,l
1,1,1,1,1,1,1,1,1,l
1,1,1,1,1,1,1,1,1,l
1,1,1,1,^,1,1,1,1,l
1,1,1,1,B,1,1,1,1,l
1,1,1,1,1,1,1,1,v,l
1,1,1,1,1,1,1,1,1,l
1,1,1,1,1,1,1,1,1,l
r,r,r,r,r,r,r,r,r,c
