1,1,0,0,1,1,1,1,1,1
1,1,1,0,0,l,1,1,1,1
1,1,1,1,1,1,1,1,1,1
1,1,1,1,1,1,1,1,1,1
1,1,1,1,1,1,1,1,1,1
1,1,1,1,1,1,1,1,1,1
1,1,1,r,1,1,1,1,1,1
1,1,r,0,c,1,1,1,1,1
c,r,0,0,0,c,1,1,1,1
0,0,0,0,0,0,c,r,r,r
,,,,,,,,,
l,1,1,1,1,1,1,1,1,1
l,1,1,1,1,1,1,1,>,1
l,1,1,1,1,1,1,1,1,1
l,1,1,1,1,1,1,1,1,1
l,1,1,1,1,1,1,1,1,1
l,1,1,l,1,1,1,1,1,1
l,1,l,1,1,1,1,1,1,1
l,l,1,1,1,1,1,r,r,1
l,1,1,1,1,v,r,0,0,c
c,r,r,r,r,r,0,0,0,0
