1,l,0,0,c,1,1,1,1,1
1,1,l,0,0,l,1,>,1,1
1,1,1,1,1,1,1,1,1,1
1,1,1,1,1,1,1,1,1,1
1,1,1,1,1,1,1,1,1,1
1,1,1,1,1,1,1,1,1,1
1,1,1,r,1,1,1,1,1,1
1,1,c,0,c,1,v,1,1,1
c,c,0,0,0,c,1,1,1,1
0,0,0,0,0,0,c,r,r,c
,,,,,,,,,
1,1,1,1,1,1,1,1,l,c
1,>,1,1,1,1,1,r,l,0
1,1,1,1,1,1,1,r,l,0
1,1,1,1,1,1,1,1,l,0
1,1,1,1,1,1,1,1,v,l
1,1,1,1,1,1,1,1,1,l
1,1,1,1,1,r,1,1,1,l
1,1,1,1,c,0,c,1,1,l
1,1,1,c,0,0,0,c,1,l
r,r,c,0,0,0,0,0,c,c
