1,1,1,1,1,1,1,1,1,l
1,1,1,1,1,1,1,1,1,l
1,1,1,1,1,1,1,1,1,l
1,1,1,1,1,1,1,1,1,l
1,1,1,1,1,1,1,1,1,l
1,1,1,1,1,1,1,1,1,l
1,1,r,1,1,1,1,1,1,l
1,l,0,1,1,1,1,1,1,l
1,1,1,1,1,1,1,r,r,c
r,r,r,r,r,r,r,0,0,0
,,,,,,,,,
1,1,1,1,1,1,1,B,1,l
1,1,1,1,1,1,1,B,v,l
1,1,1,1,1,1,1,B,B,B
1,1,bNdEwSdWw,1,1,1,1,1,1,l
1,1,1,1,1,1,1,1,1,l
1,1,1,1,1,1,1,1,1,l
1,1,1,1,1,1,1,1,1,l
1,1,1,1,1,1,r,1,1,l
1,1,1,1,1,c,0,c,r,l
r,r,r,r,c,0,0,0,0,c
