1,1,0,0,1,1,1,1,1,r
1,1,1,0,0,1,1,>,1,r
1,1,1,1,1,1,1,1,1,r
1,1,1,1,1,1,1,1,1,r
1,1,1,1,1,1,1,1,1,r
1,1,1,1,1,1,1,1,1,r
1,1,1,l,1,1,1,1,1,r
1,1,c,0,l,1,v,1,1,r
l,c,0,0,0,l,1,1,1,r
0,0,0,0,0,0,l,l,l,c
,,,,,,,,,
1,1,1,1,1,1,1,1,l,c
1,>,1,1,1,1,1,r,r,0
1,1,1,1,1,1,1,r,r,0
1,1,1,1,1,1,1,1,r,0
1,1,1,1,1,1,1,1,v,r
1,1,1,1,1,1,1,1,1,r
1,1,1,1,l,l,1,1,1,r
1,1,1,1,c,0,l,1,1,r
1,1,1,c,0,0,0,l,1,r
l,l,c,0,0,0,0,0,l,c
